James	Butt
Josephine	Darakjy
Art	Venere
Lenna	Paprocki
Donette	Foller
Simona	Morasca
Mitsue	Tollner
Leota	Dilliard
Sage	Wieser
Kris	Marrier
Minna	Amigon
Abel	Maclead
Kiley	Caldarera
Graciela	Ruta
Cammy	Albares
Mattie	Poquette
Meaghan	Garufi
Gladys	Rim
Yuki	Whobrey
Fletcher	Flosi
Bette	Nicka
Veronika	Inouye
Willard	Kolmetz
Maryann	Royster
Alisha	Slusarski
Allene	Iturbide
Chanel	Caudy
Ezekiel	Chui
Willow	Kusko
Bernardo	Figeroa
Ammie	Corrio
Francine	Vocelka
Ernie	Stenseth
Albina	Glick
Alishia	Sergi
Solange	Shinko
Jose	Stockham
Rozella	Ostrosky
Valentine	Gillian
Kati	Rulapaugh
Youlanda	Schemmer
Dyan	Oldroyd
Roxane	Campain
Lavera	Perin
Erick	Ferencz
Fatima	Saylors
Jina	Briddick
Kanisha	Waycott
Emerson	Bowley
Blair	Malet
Brock	Bolognia
Lorrie	Nestle
Sabra	Uyetake
Marjory	Mastella
Karl	Klonowski
Tonette	Wenner
Amber	Monarrez
Shenika	Seewald
Delmy	Ahle
Deeanna	Juhas
Blondell	Pugh
Jamal	Vanausdal
Cecily	Hollack
Carmelina	Lindall
Maurine	Yglesias
Tawna	Buvens
Penney	Weight
Elly	Morocco
Ilene	Eroman
Vallie	Mondella
Kallie	Blackwood
Johnetta	Abdallah
Bobbye	Rhym
Micaela	Rhymes
Tamar	Hoogland
Moon	Parlato
Laurel	Reitler
Delisa	Crupi
Viva	Toelkes
Elza	Lipke
Devorah	Chickering
Timothy	Mulqueen
Arlette	Honeywell
Dominque	Dickerson
Lettie	Isenhower
Myra	Munns
Stephaine	Barfield
Lai	Gato
Stephen	Emigh
Tyra	Shields
Tammara	Wardrip
Cory	Gibes
Danica	Bruschke
Wilda	Giguere
Elvera	Benimadho
Carma	Vanheusen
Malinda	Hochard
Natalie	Fern
Lisha	Centini
Arlene	Klusman
Alease	Buemi
Louisa	Cronauer
Angella	Cetta
Cyndy	Goldammer
Rosio	Cork
Celeste	Korando
Twana	Felger
Estrella	Samu
Donte	Kines
Tiffiny	Steffensmeier
Edna	Miceli
Sue	Kownacki
Jesusa	Shin
Rolland	Francescon
Pamella	Schmierer
Glory	Kulzer
Shawna	Palaspas
Brandon	Callaro
Scarlet	Cartan
Oretha	Menter
Ty	Smith
Xuan	Rochin
Lindsey	Dilello
Devora	Perez
Herman	Demesa
Rory	Papasergi
Talia	Riopelle
Van	Shire
Lucina	Lary
Bok	Isaacs
Rolande	Spickerman
Howard	Paulas
Kimbery	Madarang
Thurman	Manno
Becky	Mirafuentes
Beatriz	Corrington
Marti	Maybury
Nieves	Gotter
Leatha	Hagele
Valentin	Klimek
Melissa	Wiklund
Sheridan	Zane
Bulah	Padilla
Audra	Kohnert
Daren	Weirather
Fernanda	Jillson
Gearldine	Gellinger
Chau	Kitzman
Theola	Frey
Cheryl	Haroldson
Laticia	Merced
Carissa	Batman
Lezlie	Craghead
Ozell	Shealy
Arminda	Parvis
Reita	Leto
Yolando	Luczki
Lizette	Stem
Gregoria	Pawlowicz
Carin	Deleo
Chantell	Maynerich
Dierdre	Yum
Larae	Gudroe
Latrice	Tolfree
Kerry	Theodorov
Dorthy	Hidvegi
Fannie	Lungren
Evangelina	Radde
Novella	Degroot
Clay	Hoa
Jennifer	Fallick
Irma	Wolfgramm
Eun	Coody
Sylvia	Cousey
Nana	Wrinkles
Layla	Springe
Joesph	Degonia
Annabelle	Boord
Stephaine	Vinning
Nelida	Sawchuk
Marguerita	Hiatt
Carmela	Cookey
Junita	Brideau
Claribel	Varriano
Benton	Skursky
Hillary	Skulski
Merilyn	Bayless
Teri	Ennaco
Merlyn	Lawler
Georgene	Montezuma
Jettie	Mconnell
Lemuel	Latzke
Melodie	Knipp
Candida	Corbley
Karan	Karpin
Andra	Scheyer
Felicidad	Poullion
Belen	Strassner
Gracia	Melnyk
Jolanda	Hanafan
Barrett	Toyama
Helga	Fredicks
Ashlyn	Pinilla
Fausto	Agramonte
Ronny	Caiafa
Marge	Limmel
Norah	Waymire
Aliza	Baltimore
Mozell	Pelkowski
Viola	Bitsuie
Franklyn	Emard
Willodean	Konopacki
Beckie	Silvestrini
Rebecka	Gesick
Frederica	Blunk
Glen	Bartolet
Freeman	Gochal
Vincent	Meinerding
Rima	Bevelacqua
Glendora	Sarbacher
Avery	Steier
Cristy	Lother
Nicolette	Brossart
Tracey	Modzelewski
Virgina	Tegarden
Tiera	Frankel
Alaine	Bergesen
Earleen	Mai
Leonida	Gobern
Ressie	Auffrey
Justine	Mugnolo
Eladia	Saulter
Chaya	Malvin
Gwenn	Suffield
Salena	Karpel
Yoko	Fishburne
Taryn	Moyd
Katina	Polidori
Rickie	Plumer
Alex	Loader
Lashon	Vizarro
Lauran	Burnard
Ceola	Setter
My	Rantanen
Lorrine	Worlds
Peggie	Sturiale
Marvel	Raymo
Daron	Dinos
An	Fritz
Portia	Stimmel
Rhea	Aredondo
Benedict	Sama
Alyce	Arias
Heike	Berganza
Carey	Dopico
Dottie	Hellickson
Deandrea	Hughey
Kimberlie	Duenas
Martina	Staback
Skye	Fillingim
Jade	Farrar
Charlene	Hamilton
Geoffrey	Acey
Stevie	Westerbeck
Pamella	Fortino
Harrison	Haufler
Johnna	Engelberg
Buddy	Cloney
Dalene	Riden
Jerry	Zurcher
Haydee	Denooyer
Joseph	Cryer
Deonna	Kippley
Raymon	Calvaresi
Alecia	Bubash
Ma	Layous
Detra	Coyier
Terrilyn	Rodeigues
Salome	Lacovara
Garry	Keetch
Matthew	Neither
Theodora	Restrepo
Noah	Kalafatis
Carmen	Sweigard
Lavonda	Hengel
Junita	Stoltzman
Herminia	Nicolozakes
Casie	Good
Reena	Maisto
Mirta	Mallett
Cathrine	Pontoriero
Filiberto	Tawil
Raul	Upthegrove
Sarah	Candlish
Lucy	Treston
Judy	Aquas
Yvonne	Tjepkema
Kayleigh	Lace
Felix	Hirpara
Tresa	Sweely
Kristeen	Turinetti
Jenelle	Regusters
Renea	Monterrubio
Olive	Matuszak
Ligia	Reiber
Christiane	Eschberger
Goldie	Schirpke
Loreta	Timenez
Fabiola	Hauenstein
Amie	Perigo
Raina	Brachle
Erinn	Canlas
Cherry	Lietz
Kattie	Vonasek
Lilli	Scriven
Whitley	Tomasulo
Barbra	Adkin
Hermila	Thyberg
Jesusita	Flister
Caitlin	Julia
Roosevelt	Hoffis
Helaine	Halter
Lorean	Martabano
France	Buzick
Justine	Ferrario
Adelina	Nabours
Derick	Dhamer
Jerry	Dallen
Leota	Ragel
Jutta	Amyot
Aja	Gehrett
Kirk	Herritt
Leonora	Mauson
Winfred	Brucato
Tarra	Nachor
Corinne	Loder
Dulce	Labreche
Kate	Keneipp
Kaitlyn	Ogg
Sherita	Saras
Lashawnda	Stuer
Ernest	Syrop
Nobuko	Halsey
Lavonna	Wolny
Lashaunda	Lizama
Mariann	Bilden
Helene	Rodenberger
Roselle	Estell
Samira	Heintzman
Margart	Meisel
Kristofer	Bennick
Weldon	Acuff
Shalon	Shadrick
Denise	Patak
Louvenia	Beech
Audry	Yaw
Kristel	Ehmann
Vincenza	Zepp
Elouise	Gwalthney
Venita	Maillard
Kasandra	Semidey
Xochitl	Discipio
Maile	Linahan
Krissy	Rauser
Pete	Dubaldi
Linn	Paa
Paris	Wide
Wynell	Dorshorst
Quentin	Birkner
Regenia	Kannady
Sheron	Louissant
Izetta	Funnell
Rodolfo	Butzen
Zona	Colla
Serina	Zagen
Paz	Sahagun
Markus	Lukasik
Jaclyn	Bachman
Cyril	Daufeldt
Gayla	Schnitzler
Erick	Nievas
Jennie	Drymon
Mitsue	Scipione
Ciara	Ventura
Galen	Cantres
Truman	Feichtner
Gail	Kitty
Dalene	Schoeneck
Gertude	Witten
Lizbeth	Kohl
Glenn	Berray
Lashandra	Klang
Lenna	Newville
Laurel	Pagliuca
Mireya	Frerking
Annelle	Tagala
Dean	Ketelsen
Levi	Munis
Sylvie	Ryser
Sharee	Maile
Cordelia	Storment
Mollie	Mcdoniel
Brett	Mccullan
Teddy	Pedrozo
Tasia	Andreason
Hubert	Walthall
Arthur	Farrow
Vilma	Berlanga
Billye	Miro
Glenna	Slayton
Mitzie	Hudnall
Bernardine	Rodefer
Staci	Schmaltz
Nichelle	Meteer
Janine	Rhoden
Ettie	Hoopengardner
Eden	Jayson
Lynelle	Auber
Merissa	Tomblin
Golda	Kaniecki
Catarina	Gleich
Virgie	Kiel
Jolene	Ostolaza
Keneth	Borgman
Rikki	Nayar
Elke	Sengbusch
Hoa	Sarao
Trinidad	Mcrae
Mari	Lueckenbach
Selma	Husser
Antione	Onofrio
Luisa	Jurney
Clorinda	Heimann
Dick	Wenzinger
Ahmed	Angalich
Iluminada	Ohms
Joanna	Leinenbach
Caprice	Suell
Stephane	Myricks
Quentin	Swayze
Annmarie	Castros
Shonda	Greenbush
Cecil	Lapage
Jeanice	Claucherty
Josphine	Villanueva
Daniel	Perruzza
Cassi	Wildfong
Britt	Galam
Adell	Lipkin
Jacqueline	Rowling
Lonny	Weglarz
Lonna	Diestel
Cristal	Samara
Kenneth	Grenet
Elli	Mclaird
Alline	Jeanty
Sharika	Eanes
Nu	Mcnease
Daniela	Comnick
Cecilia	Colaizzo
Leslie	Threets
Nan	Koppinger
Izetta	Dewar
Tegan	Arceo
Ruthann	Keener
Joni	Breland
Vi	Rentfro
Colette	Kardas
Malcolm	Tromblay
Ryan	Harnos
Jess	Chaffins
Sharen	Bourbon
Nickolas	Juvera
Gary	Nunlee
Diane	Devreese
Roslyn	Chavous
Glory	Schieler
Rasheeda	Sayaphon
Alpha	Palaia
Refugia	Jacobos
Shawnda	Yori
Mona	Delasancha
Gilma	Liukko
Janey	Gabisi
Lili	Paskin
Loren	Asar
Dorothy	Chesterfield
Gail	Similton
Catalina	Tillotson
Lawrence	Lorens
Carlee	Boulter
Thaddeus	Ankeny
Jovita	Oles
Alesia	Hixenbaugh
Lai	Harabedian
Brittni	Gillaspie
Raylene	Kampa
Flo	Bookamer
Jani	Biddy
Chauncey	Motley
